There are many drops in the ocean...
30
....................
R....W..............
...iii..............
...S..........WWW..R
...ii.........WWW...
..........1...WWW...
...ii....ii...WWW...
....W.........iii...
............. WWW..R
...ii.......--WWW...
..............WWW...
R...........--WWW...
..............WWW...
.X..A...T.....WWW...
######..###...iii...